OOOOOOOOOOOOOOOOOOOO
O..................O
O..................O
...................O
...................O
...................O
O..................O
O..................O
O..................O
O..................O
O..................O
O..................O
OOOOOOOOOOOOOOOOOOOO
