OOOOOOOOOOOOOOOOOOOOOOOOOOOOOOOOOOOOOOOO
O......................................O
O..................................2...O
O......................................O
OOOOOOO......OOOOOOOOOOOOOOOOOOOOOOOOOOO
O.........................OO...........O
O....3....................OO.....2.....O
O.........................OO...........O
O.........................OO...........O
O.........................OO...........O
O.................^....................O
O......................................O
O........OOOOO.........................O
O........OOOOO..............OOOOOO.....O
O........OOOOO..............OOOOOO.....O
O...........................OOOOOO.....O
O...........................OOOOOO.....O
O...........................OOOOOO.....O
O..4.................................3.O
O......................................O
OOOOOOOOOOOOOOOOOOOOOOOOOOOOOOOOOOOOOOOO
